R 1203 1230
NO ./xpm_files/Bart.xpm
EA ./xpm_files/ASLEEP.xpm
WE ./xpm_files/LIZII.xpm
SO ./xpm_files/DOPE.xpm

S ./xpm_files/liza_simpson_saks.xpm





F 20,110,12
C 20,110,120



111111111111111111111111111111
1000000000000000000000111
10000000000000010000E0011
1000000000000001000000111
1000000000100000000000001
1000000020010200000111111
10000100000101110000001111
111111111111111111000111
1000000000000010000001
1000000000000010000001
1001000000000001000001
1111111111111111111111