R 1920 1080
EA ./xpm_files/ASLEEP.xpm
NO ./xpm_files/Bart.xpm
SO ./xpm_files/DOPE.xpm
WE ./xpm_files/LIZII.xpm
S ./xpm_files/liza_simpson_saks.xpm
F 167,147,144
C 20,110,1





111111111111111111111111111
1000000000000000000001
1000000000000000000001
10000000O0000000000001
10000000001000000000001
10000000200100000000001
10000100000101110000001
111111111111111111000111
1000000000000010000001
1000000000000010000001
1001000000000001000001
1111111111111111111111