R 1200 1080
NO ./xpm_files/Bart.xpm
SO ./xpm_files/DOPE.xpm
WE ./xpm_files/LIZII.xpm
EA ./xpm_files/ASLEEP.xpm
S ./xpm_files/liza_simpson_saks.xpm
F 167,14,220
F 167,14,220
C 20,110,10





111111111111111111111111111
1000000000000000000001
1000000000000000000001
10000000S0000000000001
10000000001000000000001
10000000200100000000001
10000100000101110000001
111111111111111111000111
1000000000000010000001
1000000000000010000001
1001000000000001000001
1111111111111111111111