R 800 600
no ./xpm_files/Bart.xpm
ea ./xpm_files/ASLEEP.xpm
we ./xpm_files/LIZII.xpm
so ./xpm_files/DOPE.xpm

S ./xpm_files/liza_simpson_saks.xpm




f 20,110,12
c 20,110,120




11111111111111111111111111111
1000000000000000000121111
100000000000000100000021
1000002222000001000000111
10000000001000000000N0001
1000000020010200000111111    02
10000100000101110000001111
111111111111111111000111
1000000000000010000011
1000000000000010000001
1001000000000001000001
1111111111111111111111