R 1203 123
NO ./xpm_files/Bart.xpm
EA ./xpm_files/ASLEEP.xpm
WE ./xpm_files/LIZII.xpm
SO ./xpm_files/LIZII.xpm

S ./xpm_files/liza_simpson_saks.xpm





F 20,110,12
C 20,110,120



11111111111111111111111111
10000000000000000000001111
1000000000000001000000011
10000000000E0000100000011
1000000000100000000000001111
100000002001000000011111111
1000010000010111000000111111
111111111111111111000111
1000000000000010000001
1000000000000010000001
1001000000000001000001
1111111111111111111111