R 1000   1200



NO ./xpm_files/Bart.xpm
EA ./xpm_files/ASLEEP.xpm
WE ./xpm_files/LIZII.xpm







SO                    ./xpm_files/DOPE.xpm

S                    ./xpm_files/liza_simpson_saks.xpm

F 20,110,12
C 20,110,120


1111111111111111111111
1000000000000000000121111
100000000000000100000021
1000002222000001000000111
1000000000100000000N0001
100000002001020000011111
10000100000101110000001111
111111111111111111000111
1000000000000010000011
100000000000001000011
10010000000000010001
11111111111111111111